GUI_GENERATED_MAP
NewMap
PLAYERS 1

MAP
25 X 25
OaOaOaOaOaOaOaOaOaOaOaOaOaOaOaOaOaOaOaOaOaOaOaOaOa
OaOeOeOeOeOeOeOeOeOeOeOeOeOeOeOeOeOeOeOeOeOeOeOeOa
OaOeOeOeOeOeOeOeOeOeOeOeOeOeOeOeOeOeOeOeOeOeOeOeOa
OaOeOeOeOeOeOeOeOeOeOeOeOeOeOeOeOeOeOeOeOeOeOeOeOa
OaOeOeOeOeOeOeOeOeOeOcOcOcOcOeOeOdOdOdOdOeOeOeOeOa
OaOeOeOeOeOeOeOeOeOdOcOcOcOcOdOdOdOdOdOfOeOeOeOeOa
OaOeOeOeOeOeOeOeOeOdOgOgOcOcOdOdOcOfOfOfOeOeOeOeOa
OaOeOeOeOeOeOeOeOeOdOgOgOgOcOdOcOcOfOfOfOeOeOeOeOa
OaOeOeOeOeOeOdOeOeOeOdOgOdOdOdOcOfOfOfOeOeOeOeOeOa
OaOeOeOeOeOdOdOeOeOeOeOdOdOdOdOfOfOfOfOeOeOeOeOeOa
OaOeOeOeOeOeOeOeOeOeOeOeOeOeOdOfOfOfOeOeOeOeOeOeOa
OaOeOeOeOeOeOeOeOeOeOe1BOe1BOdOdOdOdOeOeOeOeOeOeOa
OaOeOeOeOeOeOeOeOeOe1G1G1G1G1GOdOdOdOeOeOeOeOeOeOa
OaOeOeOeOeOeOeOeOe1B1G1G1G1G1G1BOdOd1A1A1AOeOeOeOa
OaOeOeOeOdOeOeOeOeOe1G1G1Z1G1G1A1A1A1AOe1AOeOeOeOa
OaOeOeOeOeOeOeOeOe1B1G1G1G1G1G1BOeOe1A1A1AOeOeOeOa
OaOeOeOeOeOeOeOeOeOe1G1G1G1G1GOeOeOeOeOeOeOeOeOeOa
OaOeOeOeOeOeOeOeOeOeOe1BOe1BOeOeOeOeOeOeOeOeOeOeOa
OaOeOeOeOeOeOeOeOeOeOeOeOeOeOeOeOeOeOeOeOeOeOeOeOa
OaOeOeOeOeOeOeOeOeOeOeOeOeOeOeOeOeOeOeOeOeOeOeOeOa
OaOeOeOeOeOeOeOeOeOeOeOeOeOeOeOeOeOeOeOeOeOeOeOeOa
OaOeOeOeOeOeOeOeOeOeOeOeOeOeOeOeOeOeOeOeOeOeOeOeOa
OaOeOeOeOeOeOeOeOeOeOeOeOeOeOeOeOeOeOeOeOeOeOeOeOa
OaOeOeOeOeOeOeOeOeOeOeOeOeOeOeOeOeOeOeOeOeOeOeOeOa
OaOaOaOaOaOaOaOaOaOaOaOaOaOaOaOaOaOaOaOaOaOaOaOaOa

THINGS
0

CREATURES
2
SPIELPROZESSE 0 0 L1 P1
IMP 9 15 L1 P1

DOORS
0

TRAPS
0

HEARTS_AND_GOLD
KPR1_HEART_CENTER 12 14
GOLD1 0

HERO_BANDS
0

AREAS
0

HERO_GATES
0

TRIGGERS
0

SCENARIO_DESCRIPTION
EOF
