GUI_GENERATED_MAP
Level2
PLAYERS 1

MAP
35 X 35
OaOaOaOaOaOaOaOaOaOaOaOaOaOaOaOaOaOaOaOaOaOaOaOaOaOaOaOaOaOaOaOaOaOaOa
OaObObObObObObObObObObObObObObObObObObObObObObObObObObObObObObObObObOa
OaObObOcOcOcOcOcOcOcOcOcOcOcOcOcOcOcOcOcOcOcOcOcOcOcOcOcOcOcOcOcObObOa
OaObOcOcOcOcOcOcOcOcOcOcOcOcOcOcOcOcOcOcOcOcOcOcOcOcOcOcOcOcOcOcOcObOa
OaObOcOcOcOcOcOcOcOcOcOcOcOcOcOcOcOcOcOcOcOcOcOcOcOcOcOcOcOcOcOcOcObOa
OaObOcOcOcOcOcOcOcOcOcOcOcOcOcOcOcOcOcOcOcOcOcOcOcOcOcOcOcOcOcOcOcObOa
OaObOcOcOcOcOcOcOcOcOcOcOcOcOcOcOcOcOcOcOcOcOcOcOcOcOcOcOcOcOcOcOcObOa
OaObOcOcOcOcOcOcOcOcOcOcOcOcOcOcOcOcOcOcOcOcOcOcOcOcOcOcOcOcOcOcOcObOa
OaObOcOcOcOcOcOcOcOcOcOcOcOcOcOcOcOcOcOcOcOcOcOcOcOcOcOcOcOcOcOcOcObOa
OaObOcOcOcOcOcOcOcOcOcOcOcOcOcOcOcOcOcOcOcOcOcOcOcOcOcOcOcOcOcOcOcObOa
OaObOcOcOcOcOcOcOcOcOcOcOcOcOcOcOcOcOcOcOcOcOcOcOcOcOcOcOcOcOcOcOcObOa
OaObOcOcOcOcOcOcOcOcOcOcOcOcOcOcOcOcOcOcOcOcOcOcOcOcOcOcOcOcOcOcOcObOa
OaObOcOcOcOcOcOcOcOcOcOcOcOcOcOcOcOcOcOcOcOcOcOcOcOcOcOcOcOcOcOcOcObOa
OaObOcOcOcOcOcOcOcOcOcOcOcOcOcOcOcOcOcOcOcOcOcOcOcOcOcOcOcOcOcOcOcObOa
OaObOcOcOcOcOcOcOcOcOcOcOcOcOcOcOcOcOcOcOcOcOcOcOcOcOcOcOcOcOcOcOcObOa
OaObOcOcOc1B1B1B1B1BOcOcOcOcOcOcOcOcOcOcOcOcOcOcOcOcOcOcOcOcOcOcOcObOa
OaOb1B1B1B1B1F1F1F1B1B1B1BOcOcOcOcOcOcOcOcOcOcOcOcOcOcOcOcOcOcOcOcObOa
OaOb1B1F1F1F1F1F1F1F1F1F1BOcOcOcOcOcOcOcOcOcOcOcOcOc1B1B1B1B1BOcOcObOa
OaOb1B1F1F1F1F1F1F1F1F1F1BOcOcOcOcOcOcOcOcOcOcOcOcOc1B1D1D1D1BOcOcObOa
OaOb1B1F1F1F1F1F1F1F1F1F1BOcOcOcOcOc1AOcOcOcOcOcOcOc1B1D1D1D1BOcOcObOa
OaOb1B1B1B1B1F1F1F1A1A1B1BOcOcOeOeOe1AOeOeOeOcOcOcOc1B1D1D1D1BOcOcObOa
OaObOcOcOc1B1F1F1F1A1B1B1B1BOeOe1G1G1G1G1GOeOe1B1B1B1B1B1B1A1BOcOcObOa
OaObOcOcOc1B1B1A1A1A1F1F1F1BOeOe1G1G1G1G1GOeOe1B1I1I1I1B1B1A1BOcOcObOa
OaObOcOcOcOc1B1F1F1F1F1F1F1A1A1A1G1G1G1G1G1A1A1A1I1I1I1A1A1A1BOcOcObOa
OaObOcOcOcOc1B1F1F1F1F1F1F1BOeOe1G1G1G1G1GOeOe1B1I1I1I1B1B1B1BOcOcObOa
OaObOcOcOcOc1B1F1F1F1B1B1B1BOeOe1G1G1G1G1GOeOe1B1B1B1B1BOcOcOcOcOcObOa
OaObOcOcOcOc1B1B1B1B1BOcOcOcOeOeOeOe1AOeOeOeOeOcOcOcOfOfOfOfOfOfOfObOa
OaObOcOcOcOcOcOcOcOcOcOcOcOcOcOeOeOe1AOeOeOgOcOcOfOfOfOgOgOgOgOgOgObOa
OaObOcOcOcOcOcOcOcOcOcOcOcOcOgOcOgOgOgOgOgOgOfOfOfOgOgOgOgOgOgOgOgObOa
OaObOcOcOcOcOcOcOcOcOcOcOcOcOgOgOgOgOgOgOgOgOfOfOgOgOgOgOgOgOgOgOgObOa
OaObOcOcOcOcOcOcOcOcOcOcOcOcOgOgOgOgOgOgOfOfOfOgOgOgOgOgOgOgOgOgOgObOa
OaObOcOcOcOcOcOcOcOcOcOcOcOcOcOcOgOgOgOfOfOfOfOgOgOgOgOgOgOgOgOgOgObOa
OaObObOcOcOcOcOcOcOcOcOcOcOcOcOcOcOcOcOfOgOgOgOgOgOgOgOgOgOgOgOgObObOa
OaObObObObObObObObObObObObObObObObObObObObObObObObObObObObObObObObObOa
OaOaOaOaOaOaOaOaOaOaOaOaOaOaOaOaOaOaOaOaOaOaOaOaOaOaOaOaOaOaOaOaOaOaOa

THINGS
0

CREATURES
2
SPIELPROZESSE 0 0 L1 P1
IMP 17 26 L1 P1

DOORS
0

TRAPS
0

HEARTS_AND_GOLD
KPR1_HEART_CENTER 18 23
GOLD1 0

HERO_BANDS
0

AREAS
0

HERO_GATES
0

TRIGGERS
0

SCENARIO_DESCRIPTION
EOF
