GUI_GENERATED_MAP
NewMap
PLAYERS 1

MAP
37 X 37
OaOaOaOaOaOaOaOaOaOaOaOaOaOaOaOaOaOaOaOaOaOaOaOaOaOaOaOaOaOaOaOaOaOaOaOaOa
OaObObObObObObObObObObObObObObObObObObObObObObObObObObObObObObObObObObObOa
OaObOcOcOcOcOcOcOcOcOcOcOcOcOcOcOcOcOcOcOcOcOcOcOcOcOcOcOcOcOcOcOcOcOcObOa
OaObOcOcOcOcOcOcOcOcOcOcOcOcOcOcOcOcOcOcOcOcOcOcOcOcOcOcOcOcOcOcOcOcOcObOa
OaObOcOcOcOcOcOcOcOcOcOcOcOcOcOcOcOcOcOcOcOcOcOcOcOcOcOcOcOcOcOcOcOcOcObOa
OaObOcOcOcOcOcOcOcOcOcOcOcOcOcOcOcOcOcOcOcOcOcOcOcOcOcOcOcOcOcOcOcOcOcObOa
OaObOcOcOcOcOcOcOcOcOgOgOcOcOcOcOcOcOcOcOcOcOcOcOcOcOcOcOcOcOcOcOcOcOcObOa
OaObOcOcOcOcOcOcOcOgOgOgOcOgOcOcOcOcOcOcOcOcOcOcOcOcOcOcOcOcOcOcOcOcOcObOa
OaObOcOcOcOcOcOcOcOgOgOgOgOgOgOgOcOcOcOcOcOcOcOcOcOcOcOcOcOcOcOcOcOcOcObOa
OaObOcOcOcOcOcOcOcOgOgOcOcOcOdOdOdOcOcOcOcOcOcOcOcOcOcOcOcOcOcOcOcOcOcObOa
OaObOcOcOcOcOcOcOcOgOcOcOcOcOdOdOdOcOcOcOc1I1I1IOcOcOcOcOcOcOcOcOcOcOcObOa
OaObOcOcOcOcOcOcOcOcOcOcOcOcOdOdOdOcOcOcOc1I1I1IOcOcOfOfOfOcOcOcOcOcOcObOa
OaObOgOcOcOcOcOcOcOcOcOcOcOcOcOdOcOcOcOcOc1I1I1IOcOcOfOfOfOcOcOcOcOcOcObOa
OaObOgOgOcOcOcOcOcOcOcOgOgOgOcOdOcOcOcOcOcOc1AOcOcOfOfOfOcOcOeOcOcOcOcObOa
OaObOgOgOgOgOgOgOcOcOcOcOgOgOcOd1B1B1B1B1B1B1A1B1BOcOfOfOcOeOeOcOcOcOcObOa
OaObOgOcOcOcOgOgOcOcOcOcOcOcOcOd1B1F1F1F1B1D1D1D1BOcOfOcOeOeOeOcOcOcOcObOa
OaObOcOcOcOcOgOcOcOdOdOdOdOdOdOdOd1F1F1F1B1D1D1D1BOcOcOcOeOcOdOcOcOcOcObOa
OaObOcOcOcOcOcOcOcOd1A1A1A1A1F1F1F1F1F1F1B1D1D1D1BOdOdOcOeOdOdOdOcOcOcObOa
OaObOcOcOcOcOgOgOgOd1A1A1A1A1F1F1F1F1F1F1B1A1A1AOdOdOdOcOeOcOdOdOcOcOcObOa
OaObOcOcOcOcOcOgOdOd1A1A1A1A1F1F1F1F1F1F1B1A1A1AOcOcOdOcOeOcOeOdOdOcOcObOa
OaObOcOcOcOcOcOcOcOc1A1A1A1A1A1A1A1F1F1F1A1AOcOcOcOcOdOcOdOeOeOeOdOcOcObOa
OaObOcOcOcOcOcOcOdOd1A1A1C1A1C1A1A1A1A1A1A1AOcOcOcOcOdOcOdOeOeOeOdOcOcObOa
OaObOcOdOdOdOdOdOdOd1A1G1G1G1G1G1A1A1A1AOcOcOcOcOcOcOdOcOdOeOeOeOeOcOcObOa
OaObOgOdOdOeOeOeOdOd1C1G1G1G1G1G1C1AOcOcOcOcOeOcOcOcOdOcOeOeOeOeOeOeOcObOa
OaObOdOdOdOdOeOeOeOd1A1G1G1G1G1G1A1AOcOcOeOeOeOeOeOcOdOcOeOeOeOeOdOdOcObOa
OaObOgOgOcOcOdOeOeOd1C1G1G1G1G1G1C1AOcOcOeOeOeOeOeOcOdOdOdOdOdOdOdOdOcObOa
OaObOcOcOcOdOeOeOeOd1A1G1G1G1G1G1AOcOeOeOeOeOeOeOcOcOdOcOcOcOcOcOdOdOcObOa
OaObOcOcOcOeOeOeOdOd1A1A1C1A1C1A1AOcOcOeOeOeOeOeOcOcOdOcOcOcOcOcOdOdOcObOa
OaObOcOcOeOeOeOeOeOd1A1A1A1A1A1AOcOcOcOeOeOeOeOcOcOdOdOcOcOcOcOdOdOcOcObOa
OaObOcOcOdOeOeOeOeOdOdOdOcOdOdOdOdOcOcOcOeOeOdOcOcOdOdOcOdOcOdOdOdOcOcObOa
OaObOcOcOdOeOeOeOdOdOdOdOdOdOdOdOdOdOdOdOdOdOdOdOdOdOdOdOdOdOdOdOdOdOdObOa
OaObOcOcOdOdOdOdOdOcOcOdOdOdOdOdOdOdOdOdOdOdOdOcOcOcOcOcOcOdOdOdOdOdOdObOa
OaObOcOcOcOcOcOcOcOcOcOcOcOcOdOdOdOdOdOcOdOdOcOcOcOcOcOcOcOdOdOdOdOdOdObOa
OaObOcOcOcOcOcOcOcOcOcOcOcOcOcOcOcOcOcOcOcOcOcOcOcOcOcOcOcOdOdOdOdOdOdObOa
OaObOcOcOcOcOcOcOcOcOcOcOcOcOcOcOcOcOcOcOcOcOcOcOcOcOcOcOcOdOdOdOcOdOdObOa
OaObObObObObObObObObObObObObObObObObObObObObObObObObObObObObObObObObObObOa
OaOaOaOaOaOaOaOaOaOaOaOaOaOaOaOaOaOaOaOaOaOaOaOaOaOaOaOaOaOaOaOaOaOaOaOaOa

THINGS
0

CREATURES
50
SPIELPROZESSE 0 0 L1 P1
IMP 9 18 L1 P1
IMP 32 24 L1 P1
IMP 14 9 L1 P1
IMP 18 30 L1 P1
GOBLIN 17 30 L1 P1
GOBLIN 17 30 L1 P1
GOBLIN 17 30 L1 P1
GOBLIN 17 30 L1 P1
GOBLIN 17 30 L1 P1
GOBLIN 17 30 L1 P1
GOBLIN 17 30 L1 P1
GOBLIN 17 30 L1 P1
GOBLIN 17 30 L1 P1
GOBLIN 17 30 L1 P1
GOBLIN 17 30 L1 P1
GOBLIN 17 30 L1 P1
GOBLIN 17 30 L1 P1
GOBLIN 17 30 L1 P1
GOBLIN 17 30 L1 P1
GOBLIN 17 30 L1 P1
GOBLIN 17 30 L1 P1
GOBLIN 17 30 L1 P1
GOBLIN 17 30 L1 P1
GOBLIN 17 30 L1 P1
GOBLIN 17 30 L1 P1
GOBLIN 17 30 L1 P1
GOBLIN 17 30 L1 P1
GOBLIN 17 30 L1 P1
GOBLIN 17 30 L1 P1
ORC 17 30 L1 P1
ORC 17 30 L1 P1
ORC 17 30 L1 P1
ORC 17 30 L1 P1
ORC 17 30 L1 P1
ORC 17 30 L1 P1
ORC 17 30 L1 P1
ORC 17 30 L1 P1
ORC 17 30 L1 P1
ORC 17 30 L1 P1
WARLOCK 17 30 L1 P1
WARLOCK 17 30 L1 P1
WARLOCK 17 30 L1 P1
WARLOCK 17 30 L1 P1
WARLOCK 17 30 L1 P1
WARLOCK 17 30 L1 P1
WARLOCK 17 30 L1 P1
WARLOCK 17 30 L1 P1
WARLOCK 17 30 L1 P1
WARLOCK 17 30 L1 P1

DOORS
0

TRAPS
0

HEARTS_AND_GOLD
KPR1_HEART_CENTER 13 24
GOLD1 0

HERO_BANDS
0

AREAS
0

HERO_GATES
0

TRIGGERS
0

SCENARIO_DESCRIPTION
EOF
