GUI_GENERATED_MAP
Level2
PLAYERS 1

MAP
35 X 35
OaOaOaOaOaOaOaOaOaOaOaOaOaOaOaOaOaOaOaOaOaOaOaOaOaOaOaOaOaOaOaOaOaOaOa
OaObObObObObObObObObObObObObObObObObObObObObObObObObObObObObObObObObOa
OaObObOcOcOcOcOcOcOcOcOcOcOcOcOcOcOcOcOcOcOcOcOcOcOcOcOcOcOcOcOcObObOa
OaObOcOcOcOcOcOcOcOcOcOcOcOcOcOcOcOcOcOcOcOcOcOcOcOcOcOcOcOcOcOcOcObOa
OaObOcOcOcOcOcOcOcOcOcOcOcOcOcOcOcOcOcOcOcOcOcOcOcOcOcOcOcOcOcOcOcObOa
OaObOcOcOcOcOcOcOcOcOcOcOcOcOcOcOcOcOcOcOcOcOcOcOcOcOcOcOcOcOcOcOcObOa
OaObOcOcOcOcOcOcOcOcOcOcOcOcOcOcOcOcOcOcOcOcOcOcOcOcOcOcOcOcOcOcOcObOa
OaObOcOcOcOcOcOcOcOcOcOcOcOcOcOcOcOcOcOcOcOcOcOcOcOcOcOcOcOcOcOcOcObOa
OaObOcOcOcOcOcOcOcOcOcOcOcOcOcOcOcOcOcOcOcOcOcOcOcOcOcOcOcOcOcOcOcObOa
OaObOcOcOcOcOcOcOcOcOcOcOcOcOcOcOcOcOcOcOcOcOcOcOcOcOcOcOcOcOcOcOcObOa
OaObOcOcOcOcOcOcOcOcOcOcOcOcOcOcOcOcOcOcOcOcOcOcOcOcOcOcOcOcOcOcOcObOa
OaObOcOcOcOcOcOcOcOcOcOcOcOcOcOcOcOcOcOcOcOcOcOcOcOcOcOcOcOcOcOcOcObOa
OaObOcOcOcOcOcOcOcOcOcOcOcOcOcOcOcOcOcOcOcOcOcOcOcOcOcOcOcOcOcOcOcObOa
OaObOcOcOcOcOcOcOcOcOcOcOcOcOcOcOcOcOcOcOcOcOcOcOcOcOcOcOcOcOcOcOcObOa
OaObOcOcOcOcOcOcOcOcOcOcOcOcOcOcOcOcOcOcOcOcOcOcOcOcOcOcOcOcOcOcOcObOa
OaObOcOcOcOcOcOcOcOcOcOcOcOcOcOcOcOcOcOcOcOcOcOcOcOcOcOcOcOcOcOcOcObOa
OaObOcOcOcOcOcOcOcOcOcOcOcOcOcOcOcOcOcOcOcOcOcOcOcOcOcOcOcOcOcOcOcObOa
OaObOcOcOc1B1B1B1B1B1B1B1B1BOcOcOcOcOcOcOcOcOcOcOcOcOcOcOcOcOcOcOcObOa
OaObOcOcOc1B1I1I1I1B1D1D1D1BOcOeOeOeOdOeOeOeOcOcOcOcOcOcOcOcOcOcOcObOa
OaObOcOcOc1B1I1I1I1A1D1D1D1BOeOeOeOe1AOeOeOeOeOcOcOcOcOfOfOcOcOcOcObOa
OaObOcOcOc1B1I1I1I1B1D1D1D1BOeOeOe1B1A1BOeOeOeOcOcOfOfOfOfOcOcOcOcObOa
OaObOcOcOc1B1B1B1B1B1B1A1B1BOeOe1G1G1G1G1GOeOeOeOcOfOfOfOfOfOcOcOcObOa
OaObOcOcOcOcOcOcOc1B1F1F1F1BOe1B1G1G1G1G1G1BOeOeOcOfOfOfOfOfOcOcOcObOa
OaObOcOcOcOcOcOcOc1B1F1F1F1A1A1A1G1G1G1G1G1A1A1AOcOcOfOfOfOcOcOcOcObOa
OaObOcOcOcOcOcOcOc1B1F1F1F1BOe1B1G1G1G1G1G1BOeOeOcOcOfOfOcOcOcOcOcObOa
OaObOcOcOcOcOcOcOc1B1B1B1B1BOeOe1G1G1G1G1GOeOeOeOcOcOcOcOcOcOcOcOcObOa
OaObOcOcOcOcOcOcOcOcOcOcOcOcOeOeOe1B1A1BOeOeOeOeOcOcOcOcOcOcOcOcOcObOa
OaObOcOcOcOcOcOcOcOcOcOcOcOcOeOeOeOe1AOeOeOeOcOcOcOcOcOgOgOgOgOgOcObOa
OaObOcOcOcOcOcOcOcOcOcOcOcOcOgOeOeOeOcOeOeOeOcOcOcOgOgOgOgOgOcOcOcObOa
OaObOcOcOcOcOcOcOcOcOcOcOcOcOgOgOgOgOgOgOgOgOcOcOgOgOgOgOgOgOcOcOcObOa
OaObOcOcOcOcOcOcOcOcOcOcOcOcOgOgOgOgOgOgOcOcOcOgOcOcOcOcOcOgOcOcOcObOa
OaObOcOcOcOcOcOcOcOcOcOcOcOcOcOcOgOgOgOcOcOcOcOcOcOcOgOgOcOcOcOcOcObOa
OaObObOcOcOcOcOcOcOcOcOcOcOcOcOcOcOcOcOcOcOcOcOcOcOcOcOgOcOcOcOcOcObOa
OaObObObObObObObObObObObObObObObObObObObObObObObObObObObObObObObObObOa
OaOaOaOaOaOaOaOaOaOaOaOaOaOaOaOaOaOaOaOaOaOaOaOaOaOaOaOaOaOaOaOaOaOaOa

THINGS
0

CREATURES
4
IMP 17 26 L1 P1
WARLOCK 13 22 L1 P1
GOBLIN 11 22 L1 P1
TROLL 9 22 L1 P1

DOORS
0

TRAPS
0

HEARTS_AND_GOLD
KPR1_HEART_CENTER 18 23
GOLD1 0

HERO_BANDS
0

AREAS
0

HERO_GATES
0

TRIGGERS
0

SCENARIO_DESCRIPTION
EOF
